NO ./path_to_the_north_texture
SO ./path_to_the_south_texture
WE ./path_to_the_west_texture
EA ./path_to_the_east_texture

F   220   ,  100 ,    0   
C    2    5  5    ,   30   ,      0   

         1111111111111111111111111
         0000000000110000000000001
         1011000001110000000000001
1111111111000000000000001111111111
111111111011000001110000000000001
100000000011001111110111111111111
111101111111101  100000010001
111101111111101  101010010001
110000001101001  100000010001
10000000000000111100000010001
10000000000000001101010010001
11000001110101011111011110N0111
11110111 1110101 101111010001
11111111 1111111 111111111111